1111111111111
100100N0000C1
100100C0000C1
100100C00NNC1
10P000C0000C1
100100C00E0C1
1111111111111