11111111111111111
100100N0000C00001
10010000EN0011111
10010000000010001
1C000N00C0001N001
10010P00C00000001
10010000000N00C01
100100000N00000N1
11111111111111111