1111111111111111111
11P0C0N001001001001
1111000010C01001001
1C00N0C000100000C01
10CN001110110C00001
1000C01E0C001001001
1111111111111111111